36222223333336222223333333333333333333333333333333333333333333333333
35111112222225111113333333333333333333333333333333333333333333333333
34000001111114000003333333333333333333333333333333333333333333333333
34000000000000000003333333333333333333333333333333333333333333333333
34000003333334000003333333333333333333333333333333333333333333333333
33334333333333342222222222222233333333333333333333333333333333333333
33334333333333341111111111111133333333333333333333333333333333333333
33334333333333340000000000000033333333333333333333333333333333333333
33334333336228622222222222222022222222223333333333333333333333333333
33334333335117511111111111111011111111113333333333333333333333333333
33334333334007400000000000000000000000003333333333333333333333333333
33334222224000000000000000340000000034003333333333333333333333333333
33334111114000000340000340240034000024003333336222233333333333333333
33334000000000000240000240000024000000002222225111133333333333333333
33333333334000000000000000000000000000001111114000033333333333333333
33333333334000000034000000034000000003400000000000033333333333333333
33333333334000000024000000024000000002403333334000033333333333333333
33333333334000000000000000000000000000003333334000033333333333333333
33333333334000000000000000000000000000003333333333333333333333333333
33333333333333333333333333333333333333333333333333333333333333333333
33333333333333333333333333333333333333333333333333333333333333333333
33333333333333333333333333333333333333333333333333333333333333333333
33333333333333333333333333333333333333333333333333333333333333333333
33333333333333333333333333333333333333333333333333333333333333333333
33333333333333333333333333333333333333333333333333333333333333333333
33333333333333333333333333333333333333333333333333333333333333333333
33333333333333333333333333333333333333333333333333333333333333333333
33333333333333333333333333333333333333333333333333333333333333333333
33333333333333333333333333333333333333333333333333333333333333333333
33333333333333333333333333333333333333333333333333333333333333333333
33333333333333333333333333333333333333333333333333333333333333333333
33333333333333333333333333333333333333333333333333333333333333333333
33333333333333333333333333333333333333333333333333333333333333333333