36222223333336222223333333333333333333333333333333333333333333333333
35111112222225111113333333333333333333333333333333333333333333333333
34000001111114000003333333333333333333333333333333333333333333333333
34000000000000000003333333333333333333333333333333333333333333333333
34000003333334000003333333333333333333333333333333333333333333333333
33333333333333333333333333333333333333333333333333333333333333333333
33333333336222223333333333333333333333333333333333333333333333333333
33333333335111113333333333333333333333333333333333333333333333333333
33333333334000002222222222222022222222223333333333333333333333333333
33333333334007001111111111111011111111113333333333333333333333333333
33333333334009000000000000000000000000003333333333333333333333333333
33333333334000000000000000340000000034003333333333333333333333333333
33333333334000000340000340240034000024003333336222233333333333333333
33333333334000000240000240000024000000002222225111133333333333333333
33333333334000000000000000000000000000001111114000033333333333333333
33333333334000000034000000034000000003400000000000033333333333333333
33333333334000000024000000024000000002403333334000033333333333333333
33333333334000000000000000000000000000003333334000033333333333333333
33333333334000000000000000000000000000003333333333333333333333333333
33333333333333333333333333333333333333333333333333333333333333333333
33333333333333333333333333333333333333333333333333333333333333333333
33333333333333333333333333333333333333333333333333333333333333333333
33333333333333333333333333333333333333333333333333333333333333333333
33333333333333333333333333333333333333333333333333333333333333333333
33333333333333333333333333333333333333333333333333333333333333333333
33333333333333333333333333333333333333333333333333333333333333333333
33333333333333333333333333333333333333333333333333333333333333333333
33333333333333333333333333333333333333333333333333333333333333333333
33333333333333333333333333333333333333333333333333333333333333333333
33333333333333333333333333333333333333333333333333333333333333333333
33333333333333333333333333333333333333333333333333333333333333333333
33333333333333333333333333333333333333333333333333333333333333333333
33333333333333333333333333333333333333333333333333333333333333333333